Water
###########
#..#12...3#
#..#......#
#.##......#
#.#..#.####
#....#....#
###.#.....#
#.....#...#
###########

123

1 H 1R
2 O 1R 1L
3 H 1L