Methanol
.........####
####.....#..#
#..#.....#..#
#..##...##.5#
#..4#####...#
#.#.#.3#....#
#......#.6..#
#..#.#...#..#
#2..........#
#...#.#...#.#
######1...#.#
.....########

.2..
1356
.4..

1 H 1R
2 H 1D
3 C 1U 1R 1D 1L
4 H 1U
5 O 1R 1L
6 H 1L