Methane
#############
#...#..#....#
#.#..#.#....#
#..#...#..#.#
#..2...####.#
#1.35...#.#.#
#..4.#..#...#
#.#####....##
#...#..#...#.
#####..#...#.
############.

.2.
135
.4.

1 H 1R
2 H 1D
3 C 1U 1R 1D 1L
4 H 1U
5 H 1L