Carbon Dioxide
############
#.3#.......#
#.##.#.#.#.#
#.#..#####.#
#2....#1...#
############

123

1 O 1R
2 C 1L 1R
3 O 1L