Hydrogen Peroxide
##########
#...#....#
#........#
#..1.2...#
#.######.#
#...#....#
#..3.4...#
##########

12
34

1 H 1R 1D
2 O 1L 1D
3 O 1R 1U
4 H 1L 1U