Formaldehyde
###########
#....1...2#
##3..#..4.#
#.........#
###########

.4.
123

1 H 1R
2 C 1R 1L 1U
3 H 1L
4 O 1D